TOP 50 Frequent|      TOP 50 most conserved
               |
------         |         ----C-
AAAAAA         |         ---C--
TTTTTT         |         TACA#G
TATATA         |         ---C-T
ATATAT         |         G----#
AAAAAT         |         CT---#
ATTTTT         |         C-T---
GAAAAA         |         TATC#G
TTTTTC         |         -CGT--
AAAATA         |         TT#ATG
TAAAAA         |         -CAGT-
AATAAA         |         AAAT#A
ATAAAA         |         TCTTC#
TATTTT         |         TTT#TG
AAGAAA         |         TC#TAA
AAATAA         |         TA#CGA
CTTTTT         |         TTGCA#
AGAAAA         |         AGT--#
TTTCTT         |         GATT#-
TTATTT         |         C-GCGG
AAAAAG         |         -GCT--
TTTTTA         |         -GGA--
TTTTAT         |         ATC#GT
TTTATT         |         A#CGAA
TTTTCT         |         AC#TAT
AAAGAA         |         AT--#-
ATAATA         |         G---#-
TTCTTT         |         --C-TA
ATATAA         |         GCTTA#
TATTAT         |         GCG-CG
AATATA         |         TTT#CT
TCTTTT         |         A#TAAA
AAATAT         |         -#-GCT
ATATTT         |         --TGG-
AAAAGA         |         #AGACA
TTATAT         |         #AGAAG
AATTTT         |         GAA#CA
TATATT         |         A#TGCA
AAAATT         |         AACC#G
AATAAT         |         ATGT#T
AATATT         |         #GGTCT
TAAATA         |         TTAT#G
ATTATT         |         -#CGAT
AAATTT         |         CTGCT#
TATAAA         |         TA--#C
TAATAA         |         --AG-C
A-----         |         C-GT--
ATATTA         |         --CGT-
TATTTA         |         CT#GCT
TAATAT         |         -#GTAC
